9999999999999999999999999999999999999999999999999999999999999999999999999999999999999999999999999999999999999999999999999999999999999
9111111111111111111111111111111111111111111111111111111111111111111111111111111111111111111111111111111111111111111111111111111111119
9111111111111111111111111111111111111111111111111111111111111111111111111111111111111111111111111999999999991111111111111111111111119
9111111111111111111111111111111111111111111111111111111111111111111111111111111111111111111111119999999999999911111111111111111111119
9111111111111111111111111111111111111111111111111111111111111111111111111111111111111111111111119999999999999911111111111111111111119
9111111111111111111111111111111111111111111111111111111111111111111111111111111111111111111111111199999999999911111111111111111111119
9111111111111111111111111111111111111111111111111111111111111111111111111111111111111111111111111111111111999911111111111111111111119
9111111111111111111111111111111111111111111111111111111111111111111111111111199999999999999999999999999999999999999999999999999991119
9111111111111111111111111111111111111111111111111111111111111111111111111111199111111111111111111111111111119111119911111911111191119
9111111111111111111111111111111111111111111111111111111111111111111111111111199111991119991119991199111111119111119911111911111191119
9111111111111111111111111111111111111111111111111111111111111111111111111111199199999999999999999999111111119999919999991919999991119
9111111111111111111111111111111111111111111111111111111111111111111111111111199119999999999999999999111111111111111111111111111991119
9111111111111111111111111111111111111111111111111111111111111111111111111111199111111111111111111111111111111111111111111111111991119
9111111111111111111111111111111111111111111111111111111111111111111111111111199111111111111111111111111111111111111119999999991191119
9111111111111111111111111111111111111111111111111111111111111111111111111111199111111111111111111999999999999111991119999999991191119
9111111111111111111111111111111111111111111111111111111111111111111111111111199111111111111111111999999999999119991119991199911991119
9111111111111111111111111111111111111111111111111111111111111111111111111111199111111111111111199999999999999111111111111111111991119
9111111111111111111111111111111111111111111111111111111111111111111111111111199111111111111111199999999999999999991111111111111991119
9111111111111111111111111111111111111111111111111111111111111111111111111111199119999999999911119999999999999999111111111111111991119
9111111111111111111111111111111111111111111111111111111111111111111111111111199119999999999911111999999999999111111111111111911991119
9111111111111111111111111111111111111111111111111111111111111111111111111111199111999119991111199999999999999999991111111111111991119
9111111111111111111111111111111111111111111111111111111111111111111111111111199111111111111111199999999999999999111119991119911991119
9111111111111111111111111111111111111111111111111111111111111111111111111111199111111111111111119999999999999119111119999999991191119
9111111111111111111111111111111111111111111111111111111111111111111111111111199111111111111111111999999999991111911119999999991191119
9111111111111111111111111111111111111111111111111111111111111111111111111111199111111111111111199999999999999999111111991119911991119
9111111111111111111111111111111111111111111111111111111111111111111111111111199111111111111111199999999999999119111111111111111991119
9111111111111111111111111111111111111111111111111111111111111111111111111111199111991119991111111999999999999111111111111111111991119
9111111111111111111111111111111111111111111111111111111111111111111111111111199119999999999911111999999999999999911111111111111991119
9111111111111111111111111111111111111111111111111111111111111111111111111111199119999999999911199999999999999119111111111111111991119
9111111111111111111111111111111111111111111111111111111111111111111111111111199111991111991111111999999999999991191111111111911991119
9111111111111111111111111111111111111111111111111111111111111111111111111111199111111111111111119999999999999911111119999999991191119
9111111111111111111111111111111111111111111111111111111111111111111111111111199999999999999111111199999999999111111119999999991191119
9111111111111111111111111111111111111111111111111111111111111111111111111111191111119111199111111111111111111111111119999999991191119
9111111111111111111111111111111111111111111111111111111111111111111111111111191111111111199111111111111111111111111111111111111991119
9111111111111111111111111111111111111111111111111111111111111111111111111111191111111111199111111119999111111999111111111111111991119
9111111111111111111111111111111111111111111111111111111111111111111111111111191111111111199111111119999111111199111111111111111991119
9111111111111111111111111111111111111111111111111111111111111111111111111111191111111111119111111111119999111199111111111111111991119
9111111111111111111111111111111111111111111111111111111111111111111111111111191111111111111111111111119991119999911111111111111991119
9111111111111111111111111111111111111111111111111111111111111111111111111111191111119999999999911111111111111111111111991199911191119
9111111111111111111111111111111111111111111111111111111111111111111111111111191111191111111111911111111111111111111119999999991191119
9111111111111111111111111111111111111111111111111111111111111111111111111111191111191111111111911111111111111111111119999999999191119
9111111111111111111111111111111111111111111111111111111111111111111111111111191111199999999119911111111111111111111119999199991191119
9111111111111111111111111111111111111111111111111111111111111111111111111111199111191119111111111111999999999999991111111111111191119
9111111111111111111111111111111111111111111111111111111111111111111111111111119991191119999119911199999999999999111111111111111191119
9111111111111111111111111111111111111111111111111111111111111111111111111111991119991111111111911199999999999111111111111111111191119
9111111111111111111111111111111111111111111111111111111111111111111111111119911111999999999999911199999999999199991111111111111191119
9111111111111111111111111111111111111111111111111111111111111111111111111111111111199111199111911199999999999111191111111111111191119
9111111111111111111111111111111111111111111111111111111111111111111111119111111111199119119911111199999999991999991111991119911191119
9111111111199999999999999999999999999999999999999999999999999999999999991111111111119911911199111199999999999111111119999999991191119
9111111111191111111111111111111111111911111111191111111111911111111191111111111111111991119111911199999999999999991119999999991191119
9111111111191111111111111111111111111911111111191111111111911111111119911111111111111199111911111111111111111111111111911111911191119
9111111111191111111111111111111111111911111111191111111111911199999999999111111111111111119911111111111111111111111111111111111191119
9111111111191111119999111111111111111999999999191999999999911991111911119999999911111111991111191111111111111111111111111111111191119
9111111111191111111199111111111111111911111111111111111111111911111911111991111991111199111119999111111111111111111111111111111191119
9111111111191111111191111111111111111111111111111111111111111991111911111191191119119991111199999911111111111111111111111111111191119
9111111111191111111111111111111111111911111111111111111111111991111111111991119111199111111999999911111911111119111111911119111191119
9111111111191111111111111111111111111911111111111111111111119111111111111999911919991111199999999111999999111999991111999999991191119
9111111111191111111111111111111111111911111111111111111111119999911111111191119911111119999999911111199991119999991111999999991191119
9111111111191111111111111111111111111991111111111111111111119999999111999991119991111199999999111111119991111119911111999999991191119
9111111111191111111111111111111111111999999999999911111111111111111111111111111111111199999911111111119911111199991111111111111191119
9111999991199999999999999999999999999999999999999911111111111111111119999999999911111111111111111199999999999999991111111111111191119
9111999991191111119111199999999999999999999999999911111111111111111119999999999911111111111111111119999999999111111111111111111191119
9111999991199999999111199999999999999999999999999999999999111111111119999999999911111111119999999999999999999119111111111111111191119
9111999991191111119111199999999999999999999999999999999999111111111119999999999911111111119999999999999999999999999111111111111191119
9111999991191111111111199999999999999999999999999911911191111111111199999999999911111111111199119999999999999111111111991119911191119
9111999999999999999111199999999999999999999999999911111111111111111199999999999911111111111111111199999999999999111111999999991191119
9111199999991111111111199999999999999999999999999999999991111111111119999999999911111111111111199999999999999111111119999999991191119
9111111111199999999111191111191111191111191111111911119999911111111199911191111911111111119999991111911111119111111111111111111191119
9111111111191111119111191111191111191111191111111911119999911111111191111999111911111111119999991111911111119999111111111111111191119
9111111111191111111111199999119999199991191999999911111111111111111111111111111111111111111111999911919999999991111111111111111191119
9111111111199999991111111111111111111111111111111111111111111111111111111111111111111111111111111111111111111111111111111111111191119
9111111111191111111111111111111111111111111111111111111111111111111111111111111111111111111111111111111111111111111111111111111191119
9111111111199999991199991999991999999191199999111111111999991111111199999911111111199999111111111999991111111119999911111111111191119
9111111111191111111911111911111911111191119991111111111199911111111111999111111111119991111111111199911111111111199111111111111191119
9111111111191111111911111911111911111191111991111111111119911111111111199111111111119991111111111119991111111111199119999191999991119
9111111111111111111911111911111911111191119999111111111999991111111119999911111111199999111111111999991111111119999119111191111191119
9111111111191111111911111911111911111191111991111111111199111111111111199111111111111991111111111119911111111111199119111191111191119
9111111111191111111911111911111911111191111111111111111111111111111111111111111111111111111111111111111111111111111119111191111191119
9111111111199999999999999999999999999999999999999999999999999999999999999999999999999999999999999999999999999999999999999999999991119
9999999999999999999999999999999999999999999999999999999999999999999999999999999999999999999999999999999999999999999999999999999999999
